1;00;00;00;00;16;09;21;21;21;19;22;12;14;13;13;13;12;13;14;12;13;12;12;12;11;12;14;09;14;10;14;11;15;11;09;08;09;09;09;10;10;11;10;12;11;13;10;13;09;13;09;12;08;12;09;11;08;11;14;08;13;08;14;07;13;07;12;06;11;06;10;06;10;07;12;07;12;07;08;10;08;05;07;06;07;07;06;08;08;08;09;07;09;06;07;08;08;07;08;06;09;05;13;10;13;11;12;11;11;11;10;10;13;09;10;09;12;08;11;08;10;08;10;05;11;05;12;05;13;05;13;06;14;05;15;05;14;06;15;07;15;08;15;09;15;09;15;10;11;04;12;04;13;04;14;04;15;06;16;07;16;08
2;00;00;00;00;27;15;27;19;28;19;29;19;31;19;30;19;32;19;26;20;27;20;28;20;29;20;30;20;31;20;32;20;33;21;26;21;27;21;28;21;29;21;30;21;31;21;32;21;25;22;26;22;27;22;28;22;29;22;30;22;31;22;32;22;33;22;25;23;26;23;27;23;29;23;30;23;31;23;32;23;33;23;34;23;24;24;25;24;26;24;27;24;28;24;28;24;29;24;30;24;31;24;32;24;33;24;34;24;29;25;30;25;31;25;32;25;33;25;34;25;28;25;27;25;26;25;25;25;25;26;26;26;27;26;28;26;29;26;30;26;31;26;32;26;33;26;26;27;27;27;28;27;29;27;30;27;31;27;32;27;33;27;26;28;27;28;28;28;29;28;30;28;31;28;32;28;31;29;32;29;30;29;29;29;28;29;27;29;25;27;24;38;22;27
3;00;00;00;00;02;02;02;03;04;03;03;04;02;06;02;07;02;08;03;07;03;06;04;05;04;04;05;03;05;05;04;06;04;07;03;08;03;09;05;04;06;03;07;03;06;04;06;05;05;06;05;07;04;08;04;09;05;08;06;07;06;06;07;05;07;04;08;03;08;02;07;02;06;02;05;02
4;00;00;00;00;17;05;18;05;19;05;20;05;21;05;22;05;16;04;17;04;18;04;19;04;20;04;21;04;22;04;16;03;17;03;18;03;19;03;20;03;21;03;22;03;23;04;23;05;23;03;18;06;19;06;20;06;21;06;22;06;17;06;15;04;16;05;16;06;15;03;13;02;10;02;11;02;12;02;14;02;15;02;16;02;17;02;18;02;19;02;20;02;21;02;22;02;23;02;17;01;18;01;19;01;20;01;21;01;22;01;23;01;24;01;16;01;15;01
5;00;00;00;00;26;01;27;01;28;01;29;01;30;01;31;01;32;01;33;01;34;01;35;01;25;02;26;02;27;02;28;02;29;02;30;02;31;02;32;02;33;02;34;02;25;03;26;03;27;03;28;03;29;03;30;03;31;03;32;03;33;03;34;03;29;05;30;05;31;05;32;05;33;05;25;04;26;04;27;04;28;04;29;04;30;04;31;04;32;04;33;04;28;05;27;05;26;05;25;05;36;01;35;02;35;03;34;04;34;05;25;01;24;02;24;03;24;04;24;05
6;00;00;00;00;42;02;43;02;44;02;44;03;44;01;43;01;42;01;43;03;42;03;41;03;41;02;40;03;40;02;39;03;39;02;41;01;40;01;38;01;39;01;38;02;37;02;38;03;37;03;36;04;36;04;37;04;38;04;39;04;40;04;41;04;42;04;43;04;44;04;36;05;37;05;38;05;39;05;40;05;41;05;42;05;43;05;44;05;36;06;37;06;38;06;39;06;40;06;41;06;42;06;43;06;44;06;38;07;39;07;40;07;41;07;42;07;43;07;44;07;40;08;41;08;42;08;43;08;44;08;41;09;42;09;43;09;44;09;37;01;36;02;36;03;35;04;35;05;35;06;36;07;37;07;37;08;38;08;39;08;40;09;40;10;41;10;42;10;43;10;44;10
7;00;00;00;00;04;12;05;11;05;12;06;13;06;14;06;11;06;12;07;13;07;14;08;13;08;14;07;12;07;11
8;00;00;00;00;18;13;19;13;20;13;21;13;17;12;18;12;19;12;20;12;21;12;17;11;18;11;19;11;20;11;22;11;21;11;16;10;17;10;18;10;19;10;20;10;21;10;22;10;17;09;18;09;19;09;20;09;21;09;22;09;23;09;17;08;18;08;19;08;20;08;21;08;22;08;23;08;23;07;22;07;21;07;20;07;19;07;18;07;17;07
9;00;00;00;00;25;12;26;12;27;12;28;12;29;11;28;11;27;11;26;11;25;11;24;11;23;11;23;10;24;10;25;10;26;10;27;10;28;10;29;10;30;10;30;10;24;09;25;09;26;09;27;09;28;09;29;09;30;09;24;08;25;08;26;08;28;08;27;08;29;08;24;07;25;07;26;07;27;07;28;07;29;07;23;06;24;06;25;06;26;06;27;06;28;06;29;06
10;00;00;00;00;35;17;36;17;37;17;38;17;35;16;36;16;37;16;38;16;35;15;36;15;37;15;38;15;39;15;34;14;35;14;36;14;37;14;38;14;39;14;34;13;35;13;36;13;37;13;38;13;39;13;40;13;33;12;34;12;35;12;36;12;37;12;38;12;39;12;40;12;32;11;33;11;34;11;35;11;36;11;37;11;38;11;39;11;40;11;31;10;32;10;33;10;34;10;35;10;36;10;37;10;38;10;39;10;31;09;32;09;33;09;34;09;35;09;36;09;37;09;38;09;39;09;30;08;31;08;32;08;33;08;34;08;35;08;36;08;30;07;31;07;32;07;33;07;34;07;35;07;30;06;31;06;32;06;33;06;34;06
11;00;00;00;00;11;20;13;20;11;19;12;19;13;19;11;18;12;18;13;18;11;17;12;17;13;17;14;17;11;16;12;16;13;16;14;16;10;15;11;15;12;15;13;15;14;15;15;15;16;15;10;14;11;14;12;14;13;14;14;14;15;14;16;14;17;15;17;14;17;13;16;13;16;12;15;13;15;12;16;11
12;00;00;00;00;15;22;16;22;17;22;18;22;16;21;17;21;18;21;19;21;15;21;14;21;14;20;15;20;16;20;17;20;18;20;19;20;14;19;15;19;16;19;17;19;18;19;19;19;20;19;14;18;15;18;16;18;17;18;18;18;19;18;20;18;15;17;16;17;17;17;18;17;19;17;20;17;21;17;15;16;16;16;17;16;18;16;19;16;20;16;18;15;19;15;20;15;21;15;18;14;19;14;20;14;21;14;22;13
13;00;00;00;00;23;19;24;19;25;19;26;19;21;18;22;18;23;18;24;18;25;18;26;18;22;17;23;17;24;17;25;17;26;17;27;17;21;16;22;16;23;16;24;16;25;16;26;16;27;16;22;15;23;15;24;15;25;15;26;15;22;14;23;14;24;14;25;14;26;14;26;13;25;13;24;13;23;13;24;12;23;12
14;00;00;00;00;28;19;29;19;30;19;31;19;32;19;28;18;29;18;30;18;31;18;32;18;33;18;29;17;30;17;31;17;32;17;33;17;34;17;28;16;29;16;30;16;31;16;32;16;33;16;34;16;28;15;29;15;30;15;31;15;32;15;33;15;34;15;27;14;28;14;29;14;30;14;31;14;32;14;33;14;30;13;31;13;32;13;33;13;31;11;30;12;31;12;32;12;27;13;28;13;29;13;29;12;30;11
15;00;00;00;00;41;13;42;13;43;13;44;13;40;14;41;14;42;14;43;14;44;14;40;15;41;15;42;15;43;15;44;15;39;16;40;16;41;16;42;16;43;16;44;16;39;17;40;17;41;17;42;17;43;17;44;17;41;12;42;12;43;12;44;12;38;18;39;18;40;18;41;18;42;18;43;18;44;18;39;19;40;19;41;19;42;19;43;19;44;19;39;20;40;20;41;20;42;20;43;20;44;20;43;21;44;21;41;11;42;11;43;11;44;11
16;00;00;00;00;12;27;13;27;14;27;15;27;16;27;13;26;14;26;15;26;16;26;17;26;14;25;15;25;16;25;17;25;18;25;19;25;20;25;13;24;14;24;15;24;16;24;17;24;18;24;19;24;14;23;15;23;16;23;17;23;18;23;19;23;13;22;14;22
17;00;00;00;00;24;27;23;27;23;26;24;26;21;25;22;25;23;25;24;25;20;24;21;24;22;24;23;24;20;23;21;23;22;23;23;23;24;23;19;22;20;22;21;22;22;22;23;22;24;22;20;21;22;21;23;21;24;21;25;21;23;20;24;20;25;20;22;20;21;20;20;20;22;19
18;00;00;00;00;39;25;39;24;38;24;37;24;36;24;35;24;40;23;39;23;38;23;37;23;36;23;35;23;34;22;35;22;36;22;37;22;38;22;39;22;40;22;41;22;42;22;34;21;35;21;36;21;37;21;38;21;39;21;40;21;41;21;42;21;33;20;34;20;35;20;36;20;37;20;38;20;33;18;34;18;35;18;36;18;37;18;38;19;37;19;36;19;35;19;34;19;33;19
19;00;00;00;00;31;34;32;34;28;33;29;33;30;33;31;33;32;33;33;33;26;32;27;32;28;32;29;32;30;32;31;32;32;32;33;32;34;32;26;31;27;31;28;31;29;31;30;31;31;31;32;31;33;31;34;31;35;31;26;30;27;30;28;30;29;30;30;30;31;30;24;30;24;28;23;28
20;00;00;00;00;32;30;33;30;34;30;35;30;36;30;37;30;38;30;39;30;33;29;34;29;35;29;36;29;37;29;38;29;39;29;33;28;34;28;35;28;36;28;34;27;35;27;36;27;34;26;35;26;36;26;37;26;35;25;36;25;37;25;38;25
21;00;00;00;00;40;30;41;30;42;30;43;30;44;30;40;29;41;29;42;29;43;29;44;29;39;28;40;28;41;28;42;28;43;28;44;28;39;27;40;27;41;27;42;27;43;27;44;27;38;26;39;26;40;26;41;26;42;26;43;26;44;26;40;25;41;25;42;25;43;25;44;25;40;24;41;24;42;24;43;24;44;24;41;23;42;23;43;23;44;23;43;22;44;22
22;00;00;00;00;20;39;21;39;22;39;23;39;24;39;25;39;26;39;27;39;25;38;26;38;21;37;23;37;24;37;25;37;26;37;21;36;22;36;23;36;24;36;25;36;21;35;22;35;23;35;24;35;25;35
23;00;00;00;00;28;39;29;39;30;39;31;39;32;39;33;39;34;39;27;38;28;38;29;38;30;38;31;38;32;38;33;38;27;37;28;37;29;37;30;37;31;37;32;37;33;37;26;36;27;36;28;36;29;36;30;36;31;36;32;36;26;35;27;35;28;35;29;35;30;35;31;35;32;35;25;34;26;34;27;34;28;34;29;34;30;34
24;00;00;00;00;34;36;35;36;36;36;37;36;38;36;35;37;36;37;37;37;38;37;34;35;35;35;36;35;37;35;38;35;35;38;36;38;37;38;38;38;39;37;34;34;35;34;36;34;37;34;36;39;37;39;38;39;39;39;40;39;36;33;36;32;37;33;37;32;38;34;39;35;39;36;40;37;39;38;40;38;41;39;38;33;38;32;37;31;38;31;35;32;36;31;33;34;34;33;35;33;33;35;33;36;34;37;34;38;35;39
25;00;00;00;00;41;37;42;37;43;37;42;38;40;36;41;36;42;36;43;36;44;37;41;38;43;38;40;35;41;35;42;35;43;35;44;35;44;36;44;38;42;39;43;39;44;39;39;34;40;34;41;34;42;34;43;34;44;34;39;33;40;33;41;33;42;33;43;33;44;33;39;32;40;32;41;32;42;32;43;32;44;32;39;31;40;31;41;31;42;31;43;31;44;31
